R 1920 1080
SO ./textures/bluestone.xpm
NO ./textures/redbrick.xpm
WE ./textures/wood.xpm
EA ./textures/greystone.xpm

S ./textures/barrel.xpm
F 0, 128, 0
C 0, 255, 255





111111111111111111    11111111111111
1000000000000000W1    10000000000001
100200000000001111    11111111100001
100000000000001001            10000111111111
100200002000000001    1111111110000000000001
10000000001000000111111100000000000111111111
100000000100000000000001100000000001
100002000000000000000000110000000001
100000000110000000000001100000000001
100000000022220002000011000000000001    1111
100000000021120000000110000000000001    1001                  
100000000022221000011100000000000001    1111
100000000000000111100000000000000001
100000000000000000000000000111111111
100000111111111111111000000000000001
1000001            10000000000000001
1111111            11111111111111111
  
 
1111
101
111
